20 20
.*.*....*.*.*..*.*.*
..........***.**.***
...*.*.****.**.***..
**....*....****...**
**.*....*.*.*..*.*.*
....****...**....***
....................
******************.*
..................**
.*******************
.................***
*****...........****
...........*.*.*..*.
***.**.*****........
****...**.......****
*************....***
***************.....
******...........**.
.................*..
....................
3 6