9 31
..******.......**.**..***....**
...***.*.**.*.*..*....**.*....*
**.**....***.**..*.**..*..****.
.***........**.*..*...*..**.*.*
***..*.*..**..**.*******.***.*.
***...*.**.*..**.*..*.*....*.**
*..******.*...**..*.*.*.*.***.*
...*.**.**...*..*.**.**.*..***.
.*.*...**.*.***.**.****....*...
2 3