5 40
******.**.****...*.*.*.**.*.***.*..*...*
*.*..*.*.**.*..**........*..*..***.**.**
*..**.......*.....*..*...****.***..*****
.*.*.**.**..**...*.**..*..**.****..**.**
..*..**..**.***...*..*..**.*..*....**.**
2 4